{
    "51": 0,
    "83": 1,
    "89": 2,
    "67": 3,
    "75": 4,
    "80": 5,
    "49": 6,
    "40": 7,
    "XXXXXXX": 8,
    "43": 9,
    "XXXXX": 10,
    "45": 11,
    "82": 12,
    "77": 13,
    "R": 14,
    "69": 15,
    "71": 16,
    "61": 17,
    "54": 18,
    "78": 19,
    "52": 20,
    "88": 21,
    "53": 22,
    "70": 23,
    "XXXXXXXXXXXXXXX": 24,
    "XXX": 25,
    "60": 26,
    "79": 27,
    "46": 28,
    "84": 29,
    "XX": 30,
    "66": 31,
    "XXXXXXXXXXX": 32,
    "74": 33,
    "41": 34,
    "55": 35,
    "56": 36,
    "86": 37,
    "76": 38,
    "57": 39,
    "64": 40,
    "63": 41,
    "48": 42,
    "81": 43,
    "/": 44,
    "73": 45,
    "58": 46,
    "85": 47,
    "68": 48,
    "62": 49,
    "65": 50,
    "47": 51,
    "59": 52,
    "72": 53,
    "50": 54,
    "X": 55
}